=StartUpServlet
login=LoginServlet
login-page=login.jsp
invalid-page=invalid.html
home=LoadHomePageServlet
home-page=home.jsp
register=CreateAccountServlet
register-page=register.html
register-page-error=register.jsp
send-activation-code-servlet=SendActivationCodeServlet
active-account=ActiveAccountServlet
active-account-page=active-account.jsp
resend-code=SendActivationCodeServlet
logout=LogoutServlet
load-image=LoadImageCarServlet
search-car=SearchCarServlet
view-detail=ViewCarDetailServlet
car-detail-page=car-detail.jsp
rente-car=RenteCarServlet
view-cart=ViewCartServlet
view-cart-page=view-cart.jsp
calculate-total-price=CalculateTotalPriceServlet
update-quantity-car=UpdateQuantityCarServlet
delete-car-item=DeleteCarItemServlet
checkout=CheckOutCartServlet
order-history=OrderHistoryServlet
order-history-page=order-history.jsp
search-order=SearchOrderServlet
delete-order=DeleteOrderServlet
send-feedback=SendFeedbackServlet